    #####
    #   #
    #   #
  ###  b###
  #    b  #
### # # # #######
#   # # # ##   0#
# b       s     #
#####      #   0#
    #############
